....##..
#...##..
##.....#
........
..#..#..
.T#T.#..
.T#T.#..
#TT##...