..##....
..##TTT.
....TT#.
.#..TT#.
.##.....
........
....##..
........