........
........
...##...
...#....
.TTT....
.TTT....
.TTT....
......##