........
........
....TTT.
....#TT.
....TTT.
........
........
........