TT##....
TT#...##
TTT...##
........
........
........
...##...
........